#.....................#
#.....................#
#..xx.......xxx.......#
#..##.......###...x..x#
#.....................#
#.....................#
#.......###.......#..##
##...##...x.###......x#
#.....................#
#..##.....#.....xx..###
#.................... #
#xx....###..##..##....#
#.....................#
#.....................#
####..xx..##......x..##
#.....................#
#....###...##.##.##...#
#...................xx#
#.....................#
#"""""""""""""""""""""#